                                                                
                                                                
                                                                
                                                                
                                                                
                                                                
                                                                
                                                                
                                                                
                                                                
                                                                
                                                                
                                                                
                                                                
                                  #                             
                                  ##########                    
                                                                
                                                                
                              ######                            
                                                                
                           ###### ######                        
                                                                
                        ###### ###### ######                    
                                                                
                     ###### ###### ###### ######                
                                                                
                  ###### ###### ###### ###### ######            
                                                                
                         #                                      
               ###########                                      
                                                                
                                                                
            #####                                               
                                                                
         ##### #####                                            
                                                                
      ##### ##### #####                                         
                                                                
   ##### ##### ##### #####                                      
                                                                
##### ##### ##### ##### #####                                   
                                                                
                                                                
                                               #                
                                               #   #            
                                               #   #            
                                               #   #   #        
                                               #   #   #        
                                               # # #   #        
                                               # # #   #        
                                               # # # # #        
                                               # # # # #        
                                               # # # # #        
                                               #########        
                                                                
                                                                
                                                       #  #     
                                                       #  #     
                                                       #  #     
                                                       #  #     
                                                    ####  ######
                                                    #          #
                                                    #          #
                                                    #          #
                                                    #          #
                                                    #          #
                                                    ############
                                                                
                                                                
                                                #   #           
                                                #   #           
                                              ###   ######      
                                              #          #      
                                              #          #      
                                              #          #      
                                              #          #      
                                              ############      
                                                                
                                                                
                                           #####                
                                                                
                                        ##### #####             
                                                                
                                     ##### ##### #####          
                                                                
                                  ##### ##### ##### #####       
                                                                
                               ##### ##### ##### ##### #####    
                                                                
                                                                
                             #  #                               
                             #  #                               
                        ######  ########                        
                        #              #                        
                        #              #                        
                        #              #                        
                        #              #                        
                        #              #                        
                        #              #                        
                        #              #                        
                        ################                        
                                                                
                                                                
                                                                
                     #      #                                   
                     ########                                   
                                                                
                                                                
                                                                
                                                                
                     #                                          
               #   # #                                          
               #   # #                                          
               #   # #                                          
               #   # #                                          
               #   # #                                          
               # # # #                                          
               # # # # #                                        
               #########                                        
                                                                
                                                                
               #                 #                              
               ###################                              
                                                                
                                                                
                               ######                           
                                                                
                            ###### ######                       
                                                                
                         ###### ###### ######                   
                                                                
                      ###### ###### ###### ######               
                                                                
                                                                
      #         #   #                                           
      #         #   #                                           
      #         # # #                                           
      #       # # # #                                           
      #       # # # #                                           
      #       # # # #                                           
      # #     # # # #                                           
      # #     # # # #                                           
      # #   # # # # #                                           
      # # # # # # # #                                           
      ###############                                           
                                                                
                                                                
                   #   #                                        
                   #   #                                        
                  ##   ##                                       
                  #     #                                       
                  #     #                                       
                  #     #                                       
                  #######                                       
                                                                
                                                                
            #   #   #                                           
            #   #   #                                           
            #   #   #                                           
          # #   #   # #                                         
          # #   #   # #                                         
          # #   #   # #                                         
          # #   #   # #                                         
          # #   # # # #                                         
          # #   # # # #                                         
          # # # # # # #                                         
          #############                                         
